NO ./textures/wall.png
SO ./textures/eagle.png
WE ./textures/bluestone.png
EA ./textures/east.png

F 255,255,255
C 0,0,255

1111111111111111111111111
1000000000000000000000001
1000000000100000000000001
1000000000000000000000001
100000000000N000000000001
1111111111111111111111111