NO ./textures/wall.png
SO ./textures/eagle.png
WE ./textures/bluestone.png
EA ./textures/east.png

F 255,255,255
C 0,0,255

1111111111111111111111111
1000000000000000000000001
1000000000100000000000001
1000000000000000000000001
100000000000N000000000001
10000000000000000000000011111111
1111000000000000000010001
1111111111110111111111111
11000000110101011100000010001
10000000000000001100000010001
10000000000000001101010000001
1100000111010101110101011000111
11110111 1110101 101110000001
11111111 1111111 111111111111